'##:::::'##:'########:'##::::::::'######:::'#######::'##::::'##:'########::::'########::'#######:::::'########:'##::::'##:'########::::'########::'##::::'##:'##::: ##::'######:::'########::'#######::'##::: ##:
 ##:'##: ##: ##.....:: ##:::::::'##... ##:'##.... ##: ###::'###: ##.....:::::... ##..::'##.... ##::::... ##..:: ##:::: ##: ##.....::::: ##.... ##: ##:::: ##: ###:: ##:'##... ##:: ##.....::'##.... ##: ###:: ##:
 ##: ##: ##: ##::::::: ##::::::: ##:::..:: ##:::: ##: ####'####: ##::::::::::::: ##:::: ##:::: ##::::::: ##:::: ##:::: ##: ##:::::::::: ##:::: ##: ##:::: ##: ####: ##: ##:::..::: ##::::::: ##:::: ##: ####: ##:
 ##: ##: ##: ######::: ##::::::: ##::::::: ##:::: ##: ## ### ##: ######::::::::: ##:::: ##:::: ##::::::: ##:::: #########: ######:::::: ##:::: ##: ##:::: ##: ## ## ##: ##::'####: ######::: ##:::: ##: ## ## ##:
 ##: ##: ##: ##...:::: ##::::::: ##::::::: ##:::: ##: ##. #: ##: ##...:::::::::: ##:::: ##:::: ##::::::: ##:::: ##.... ##: ##...::::::: ##:::: ##: ##:::: ##: ##. ####: ##::: ##:: ##...:::: ##:::: ##: ##. ####:
 ##: ##: ##: ##::::::: ##::::::: ##::: ##: ##:::: ##: ##:.:: ##: ##::::::::::::: ##:::: ##:::: ##::::::: ##:::: ##:::: ##: ##:::::::::: ##:::: ##: ##:::: ##: ##:. ###: ##::: ##:: ##::::::: ##:::: ##: ##:. ###:
. ###. ###:: ########: ########:. ######::. #######:: ##:::: ##: ########::::::: ##::::. #######:::::::: ##:::: ##:::: ##: ########:::: ########::. #######:: ##::. ##:. ######::: ########:. #######:: ##::. ##:
:...::...:::........::........:::......::::.......:::..:::::..::........::::::::..::::::.......:::::::::..:::::..:::::..::........:::::........::::.......:::..::::..:::......::::........:::.......:::..::::..::