
██╗    ██╗███████╗██╗      ██████╗ ██████╗ ███╗   ███╗███████╗    ████████╗ ██████╗     ████████╗██╗  ██╗███████╗    ██████╗ ██╗   ██╗███╗   ██╗ ██████╗ ███████╗ ██████╗ ███╗   ██╗
██║    ██║██╔════╝██║     ██╔════╝██╔═══██╗████╗ ████║██╔════╝    ╚══██╔══╝██╔═══██╗    ╚══██╔══╝██║  ██║██╔════╝    ██╔══██╗██║   ██║████╗  ██║██╔════╝ ██╔════╝██╔═══██╗████╗  ██║
██║ █╗ ██║█████╗  ██║     ██║     ██║   ██║██╔████╔██║█████╗         ██║   ██║   ██║       ██║   ███████║█████╗      ██║  ██║██║   ██║██╔██╗ ██║██║  ███╗█████╗  ██║   ██║██╔██╗ ██║
██║███╗██║██╔══╝  ██║     ██║     ██║   ██║██║╚██╔╝██║██╔══╝         ██║   ██║   ██║       ██║   ██╔══██║██╔══╝      ██║  ██║██║   ██║██║╚██╗██║██║   ██║██╔══╝  ██║   ██║██║╚██╗██║
╚███╔███╔╝███████╗███████╗╚██████╗╚██████╔╝██║ ╚═╝ ██║███████╗       ██║   ╚██████╔╝       ██║   ██║  ██║███████╗    ██████╔╝╚██████╔╝██║ ╚████║╚██████╔╝███████╗╚██████╔╝██║ ╚████║
 ╚══╝╚══╝ ╚══════╝╚══════╝ ╚═════╝ ╚═════╝ ╚═╝     ╚═╝╚══════╝       ╚═╝    ╚═════╝        ╚═╝   ╚═╝  ╚═╝╚══════╝    ╚═════╝  ╚═════╝ ╚═╝  ╚═══╝ ╚═════╝ ╚══════╝ ╚═════╝ ╚═╝  ╚═══╝
                                                                                                                                                                                    
